B   B   B   B   B   B   B   B   B   B   B
B   .   .   B   B   .   B   C   .   .   B
B   B   .   B   .   .   X   B   B   .   B
B   .   .   B   B   .   B   B   .   .   B
B   .   .   .   B   .   .   .   .   B   B
B   .   B   B   .   C   B   B   .   .   B
B   .   X   B   .   .   B   B   B   .   B
B   B   .   B   B   .   B   X   B   .   B
X   .   C   .   .   .   .   .   .   .   B
B   B   B   B   B   B   B   B   B   X   B